1 1 1 1 1 1 1 1 1
1 5 -1 1 6 1 6 5 1
2 0 0 1 4 1 0 0 2
0 2 2 4 4 4 2 2 0
0 0 0 1 4 1 0 0 0
0 0 0 0 0 0 0 0 0
0 0 0 0 0 0 0 0 0
0 0 0 0 0 0 0 0 0
0 0 0 0 0 0 0 0 0
0 0 0 0 0 0 0 0 0