1 2 1 2 1 2 1 2 1
0 6 4 0 4 0 4 6 0
0 0 6 1 2 1 6 0 0
1 6 5 0 5 0 5 6 1
4 2 1 2 1 2 1 2 4
0 0 0 0 0 0 0 0 0
5 1 1 1 5 1 1 1 5
0 0 0 0 0 0 0 0 0
0 0 0 0 0 0 0 0 0
0 0 0 0 0 0 0 0 0