0 1 1 2 1 2 1 1 0
2 6 4 1 4 1 4 6 2
0 0 0 6 1 6 0 0 0
0 2 6 1 4 1 6 2 0
0 0 2 1 4 1 2 0 0
4 0 4 1 4 1 4 0 4
6 1 0 0 1 0 0 1 6
0 0 0 0 0 0 0 0 0
0 0 0 0 0 0 0 0 0
0 0 0 0 0 0 0 0 0