0 0 0 0 0 0 0 0 0
1 1 1 1 1 1 1 1 1
5 0 2 3 3 3 2 0 5
0 0 1 1 1 1 1 0 0
0 0 1 -1 5 -1 1 0 0
0 0 0 0 0 0 0 0 0
0 0 0 0 0 0 0 0 0
0 0 0 0 0 0 0 0 0
0 0 0 0 0 0 0 0 0
0 0 0 0 0 0 0 0 0